########################################
#                                      #
#                                      #
#                                #######
#                          ####  #  X  #
#                   B            #     #
#                          #######     #
#                                      #
#                                      #
#                                      #
#                                      #
#                                      #
#                                      #
#                                      #
#                                      #
#                                      #
#                                      #
#                                      #
#                                     P#
########################################
