##########
#        #
# B   P  #
#        #
# X  B   #
# X      #
# X B    #
#        #
#  B X   #
##########
